1111111111111
10010000000C1
1PPPP11111001

100011E00P001
1111111111111