1111111111111
1invalid_cha1
1P0C011111001
100011E00P001
1111111111111