111111111111111
111100000C01C01
1000010E0001001
1P0000000001001
111111111111111