111111111111111
111100000C00001
1001000E0000001
1P0100000000001
111111111111111