1111111111111
10010000000C1
1011111111000
100011E00P001
1111111111111