1111111111111
10010000000C1
1PPPP11111111
100011E00P1
11111111111