11111111111111
10010000000001
10000111110001
1C001100000001
1P00000E000001
11111111111111
